111111111111111111111111
100000000000000000000001
10000000000000C000000001
100000000E000P0000000001
111111111111111111111111
