11111111111111
10000000000E11
10000C000000001
1000000P000001
11111111111111