11111111111111
10000000000011
10000000000001
1000000E000001
11111111111111