11111111111111
10000000000011
100000000E0001
1000000C000001
11111111111111