11111111111111
10000000000011
1000000000C001
1000000P000001
11111111111111