11111111111111111111111111111111
1000C000000CC00000111111111000E1
1111110000C0000000000C0000000001
1111C000000000000010000000000001
11111111000000000000000000000001
1000P000000000000000000111111111
11111111111111111111111111111111